111111111111111
111P000101C0001
100000010010001
111E10000000X01
111111111111111
